11 10
1111111111
1011001101
1010010001
1001000001
1000011101
1111001001
1001101011
1101000011
1100011001
1000000001
1111111111